┌────────────────────────────┐
│                            │
│                            │
│                            │
│                            │
│                            │
│                            │
│                            │
│                            │
│                            │
│                            │
│                            │
│                            │
│                            │
│                            │
│                            │
└────────────────────────────┘