┌───────────┬──┬─────────────┐
│█          │  │             │
│  ───────┐ │  │ ┌─────────┐ │
│         │ │  │ │    #    │ │
│ ┌───────┘ │  │ │         │ │
│ │         │  │ └────┐ │ #│ │
│ │ ┌───────┘  │      │ │ ─┘ │
│#│ │          │ ┌──┐ │ │    │
│ │ │   ┌──────┘ │  │#│ │ #  │
│ │ │   │        │  │ │ │    │
│ │ └───┘ ┌──────┘  │   │    │
│ │       │#        │ ┌─┴──┐ │
│ └───────┘  │   ┌──┘ │    │ │
│            │ │ │ #  │    │#│
├──┐ ┌───────┤ └─┘    └────┘ │
│  │ │       │     #         │
└──┴─┴───────┴───────────────┘