┌──┬────────┬──┬─────────────┐
│█ │        │  │             │
│  └──────┐ │  │ ┌─────────┐ │
│         │ │  │ │         │ │
│ ┌───────┘ │  │ │         │ │
│ │         │  │ └────┐ │  │ │
│ │ ┌───────┘  │      │ │ ─┘ │
│#│ │          │ ┌──┐ │ │    │
│ │ │   ┌──────┘ │  │#│ │    │
│ │ │   │        │  │ │ │    │
│ │ └───┘ ┌──────┘  │   │    │
│ │       │         │ ┌─┴──┐ │
│ └───────┘  │   ┌──┘ │    │ │
│            │ │ │    │    │#│
├──┐ ┌───────┤ └─┘    └────┘ │
│  │B│       │               │
└──┴─┴───────┴───────────────┘